0 0 0 0 0 0 0 0 0 0 0 0 0 0 0 0 0 0 0 0 0 0 0 0 0 0 0 0 0 0 0 0 0 0 0 0 0 0 3 3 3 0 0 0 0 0 0 0 0 0 0 0 0 0 0 0 0 0 0 0 
0 0 6 6 0 0 0 0 6 6 6 6 6 0 0 0 0 0 0 0 0 6 6 6 6 6 0 0 0 0 0 0 0 0 0 0 0 0 3 6 3 0 0 0 0 6 6 6 0 6 0 6 0 0 0 0 0 0 0 0 
0 0 0 0 0 0 0 0 0 0 0 0 0 0 0 0 0 0 0 0 0 0 0 0 0 0 0 0 0 0 4 4 0 0 0 0 0 0 3 3 3 0 0 0 0 6 0 6 0 6 6 0 0 0 0 0 0 0 7 0 
0 0 0 0 0 0 0 2 2 4 3 3 3 3 3 0 0 0 0 0 2 2 2 3 3 2 2 0 0 0 0 0 0 6 0 0 0 0 3 0 0 0 0 0 0 6 6 6 0 6 0 6 0 0 0 0 0 0 4 1 
0 0 0 0 0 0 0 0 0 0 0 0 0 0 0 0 0 0 0 0 0 0 2 2 2 2 0 0 0 0 0 0 6 6 0 0 0 0 3 0 0 0 0 0 0 0 0 0 0 0 0 0 3 0 0 6 0 0 4 1 
3 3 0 0 0 0 0 0 0 0 0 0 0 0 0 0 0 0 0 0 0 0 0 0 0 0 0 0 0 0 0 6 6 6 0 0 0 0 0 0 0 0 0 3 0 0 0 0 0 0 0 0 5 0 0 3 0 0 4 1 
1 1 0 0 3 0 0 0 0 0 0 0 0 4 6 0 0 0 0 0 0 0 0 0 0 0 0 0 0 0 0 0 0 0 0 0 0 0 0 0 0 6 3 3 0 0 0 0 0 0 0 0 5 0 0 5 0 0 1 1 
2 2 0 3 3 3 6 0 0 0 0 0 0 4 4 6 0 0 0 0 0 4 4 0 0 0 0 0 0 0 0 0 0 0 0 0 0 0 0 1 1 1 1 1 1 1 0 0 0 0 0 3 5 3 0 5 0 3 2 2 
2 2 1 1 1 1 1 1 0 0 0 0 1 4 4 4 6 0 0 0 0 4 4 3 3 3 3 3 3 3 3 0 0 0 0 0 0 1 1 1 1 1 1 1 1 1 2 0 0 0 0 3 5 5 0 5 0 1 2 2 
1 1 1 1 1 1 1 1 0 0 0 1 1 2 2 2 2 0 0 0 0 2 2 1 1 1 1 1 1 1 1 1 0 0 0 1 1 1 1 1 1 1 1 1 1 1 2 2 0 0 0 3 5 5 0 5 1 2 2 2
